43
15
T000000000000000000000000000000000000000000
0000000000000000000000000000000000000000000
0000000000000000000000000000000000000000000
0000000000000000000000000000000000000000000
0000000000000000000000000000000000000000000
0000000000000000000000000000000000000000000
0000000000000000000000000000ZZZZZZZ00000000
000000000000000000ZZZZZZZZZ0000000000000000
0000000000000000000000000000000000000000000
Q03000Q00000000Q000000Q0000000000Q000000000
000000000000000Z000000000000000000000000000
00000000000000ZZZ00000000000000000000000000
000ZZ00000000ZZZZZ0000000000000000000000000
000ZZZ000000ZZZZZZZ000000000Z000000000Z0000
E000E00E0000E0000E00E00000E0000E0000E000000