43
15
T000000000000000000000000000000000000000000
0000000000000000000000000000000000000000000
0000000000000000000000000000000000000000000
0000000000000000000000000000000000000000000
0000000000000000000000000000000020000000000
0000000000000000000000000000000000000000000
00000000000000000000000M0000ZZZZZZZ00000000
000000000000000000ZZZZZZZZZ0000000000000000
0000000000000000000000000000000000000000000
Q00000Q00000000Q000000Q0000000000Q000000000
000000000000000Z0M0000000000000000000000000
00000000000000ZZZ00000000000000000000000000
003ZZ00000000ZZZZZ0000000000000000000000000
000ZZZ00M000ZZZZZZZ00000M000Z00000M000Z0000
E000E00E0000E0000E00E00000E0000E0000E000000