130
15
Y000000000000000000000000000000000000000000000000000000000000000000G00000000000000000000000000000000000000000000000000000000000000
0000000000000000000000000000000000000000000000000000000000000000000G00000000020000000000000000000000000000000000000000000000000000
0000000000000000000000000000000000000000000000000000000000000000000G0000000N000G00000000000000000000000000000000000000000000000000
0000000000000000000000000000000000000000000000000000000000000000000GG00GGGGGGGGG00000000000000000000000000000000000000000000000000
0000000000000000000000000000000000000000000000000000000000000000000GG0000000000G00000000000000000000000000000000000000000000000000
0000000000000000000000000000000000000000000000000000000000000000000GGG0000G0000G00GG0000000000000000000000000000000000000000000000
000000000000000000000000000000000000000000GGG0G00G0GGG0000000000000GGG0000G0000G00000000GG000000000000000M000000000000000000000000
0000000000000000000000000000000000000000000G00GG0G00G00000000000000GGGGGGGGGG00G0000000000000000000000GGGGGGGGGG000000000000000000
0000000000000000000000000000000000000000000G00G0GG00G00200000000000000000000000G000000000000000000C0000000000000000000000000000000
00000000000000000000000000000000000000000G0G0MG00G0MG0G00000000000000000000000GG0000000000000GG00000000000000000000000000000000000
0030000000000000000000000000000000000000GGGG00GGGG00GGGG000000000000GG00GG00GGGG0000000000000000000000G00G00G00G000000000000500000
00000000000GGGGGG0000C000G00000000000000GBBBBBBBBBBBBBBG00000000000GVVVVVVVVVVVG00000000000000000000000000000000000000000000000000
000GG000000GGGGGG00000000G0000000000000GGNMNMNMNMNMNMNMGG000N000000GGGGGGGGGGGGG000000000000000000GG00000000000000GGG00G000GGG0000
000GGG00L00GGGGGGVVVVVVVVG00000M0M0L000GVVVVVVVVVVVVVVVGG0000L00000GGGGGGGGGGGGGVVVVVVVVVVVVVVVVVVVVVVVVVVVVVVVVVVVVVVVVVVVVV00000
A0A00A000AA00A00A000A000A0000A00A00A00A000A0000AA000A00A000A0A0A000A0000A0000A0000A00A00A0000A00A0A0AA000AA000A0000A000A00A0000000