130
15
Y000000000000000000000000000000000000000000000000000000000000000000G00000000000000000000000000000000000000000000000000000000000000
0000000000000000000000000000000000000000000000000000000000000000000G0000000M000000000000000000000000000000000000000000000000000000
0000000000000000000000000000000000000000000000000000000000000000000G000GGGGGGGGG00000000000000000000000000000000000000000000000000
0000000000000000000000000000000000000000000000000000000000000000000GG0000000000G000GG000000000000000000000000000000000000000000000
0000000000000000000000000000000000000000000000000000000000000000000GGG000000000G00000000000000000000000000000000000000000000000000
0000000000000000000000000000000000000000000000000000000000000000000GGG0LN0G0000G00000000000000000000000000000000000000000000000000
000000000000000000000000000000000000000000GGG0G00G0GGG0000000000000GGG0000G0000G00000000GG0000000000000000000000000000000000000000
0000000000000000000000000000000000000000000G00GG0G00G00000000000000GGGGGGGGGG00G00000000000000000000000000M00000000000000000000000
0000000000000000000000000000000000000000000G00G0GG00G00000000000000000000000000G0000000000000000000000GGGGGGGGGG000000000000000000
00000000000000000000000000000000000000000G0G0MG00G0MG0G00000000000000000000000GG0000000000000GG00000000000000000000000000000000000
0000000000000000000000000000000000000000GGGGGGGGGGGGGGGG000000000000GG00GG00GGGG0000000000000000000000G00G00G00G000000000000000000
00300000000GGGGGG0000C000G00000000000000G00000000000000G00000000000GVVVVVVVVVVVG00000000000000000000000000000000000000000000000000
000GG000000GGGGGG00000000G0000000000000GG00000000000000GG0000000000GGGGGGGGGGGGG000000000000000000GG00000000000000GGG0000000000000
000GGG00L00GGGGGGVVVVVVVVG00000M0M0L000GG00000000000000GG0000000000GGGGGGGGGGGGGVVVVVVVVVVVVVVVVVVVVVVVVVVVVVVVVVVVVVVVVVVVVV00000
A0A00A000AA00A00A000A000A0000A00A00A00A000A0000AA000A00A000A0A0A000A0000A0000A0000A00A00A0000A00A0A0AA000AA000A0000A000A00A0000000