116
15

00000000000000000000000000000000000000000000000000000000000000000000000000000000000000000000000000000000000000000000
00000000000000000000000000000000000000000000000000000000000000000000000000000000000000000000000000000000000000000000
00000000000000000000000000000000000000000000000000000000000000000000000000000000000000000000000000000000000000000000
00000000000000000000000000000000000000000000000000000000000000000000000000000000000000000000000000000000000000000000
00000000000000000000000000000000000000000000000000000000000000000000000000000000000000000000333333333333330000000000
00000000000000000000000000000000000000000000000000000000000000000000000000000000000000000000300000000000030000000000
00000000000000000000000000000000000000000000000000000000000000000000000000000000000000003000300000000000030000000000
000000000000000000000000000033333300003333300000000000000000000Z0000000000000000000030000000300333333333030000000000
00000000000000000000000003333000003333300000000000000000003333333000000000000000000000000000300300030003030000000000
Q0000Q000000000Q00000000000000000Q0000000Q000000Q0000000000000Q000000000Q00000000000Q0000000330300030003030000000000
00000000000000000033000000000000000000000000030000000000000000000003000000000000000000000000300303000300030000000000
00000000000000000333300000000000000000000003330000000003000000000003300000000333333000000003300303000300030000000000
00533333000000003333330000000030030030030033330000000003000000000003330000000000000000000000003303333333330000000000
00033333000000033333333000000330000000000033330000000003000000000003333000000000000000000000033300000000000000000000
E00000E000000E00E00000E0000000E000000E0000000E00000E0000E00000E00000E00000E00Q00E000000E00000000E000000E000000000000