26
13
T0000000000000000000000000
00000000000000000000000000
00000000000000000000000000
00300000000000000000000000
Q0000000000000000000000000
0000000Q000000Z00Q000000Q0
0000000000000ZZZ0000000000
000000000000ZZZZZ000000000
0030000M000ZZZZZZZ00000000
E000000E00000E00000E0000E0
00000000000000000000000000
00000000000000000000000000