146
15
T0000000000000000000000000000000000000000000000000000000000000000000000000000000000000000000000000000000000000000000000000000000000000000000000000
00000000000000000000000000000000000000000000000000000000000000000000000000000000000000000000000000000000000000000000000000000000000000000000000000
00000000000000000000000000000000000000000000000000000000000000000000000000000000000000000000000000000000000000000000000000000000000000000000000000
00000000000000000000000000000000000000000000000000000000000000000000000000000000000000000000000000000000000000000000000000000000000000000000000000
0000000000000000000000000000000000000000000000000000000000000000000000000000000000000000000ZZZZZZZZ0ZZZZZ00000000000000000000000000000000000000000
000000000000000000000000000000000000000000000ZZZZ000000000000000000000000000000000000000000Z000000000000Z00000000000000000000000000000000000000000
000000000000000000000000000N0000mN0C000000000000000ZZ0000000000000000000000000000000000Z000Z000000000000Z00000000000000000000000000000000000000000
00000000000000000000000000000ZZZZZBBBBZZZZZ0000000000000Z00M0000Z00000000000000000000000000Z00ZZZZZZZZZ0Z00000000000000000000000000000000000000000
000000000000000000000000ZZZZZ00000ZZZZ00000002000000000Z0ZZZZZZZ0000000000000000000Z0000000Z00Z000Z000Z0Z0000000000000ZZZZZZZZZZ000000000000000000
Q0000Q000000000Q00000000000000000Q0000000Q000000Q000000Z000000Q000000000Q00000000000Q000000ZZ0Z000Z000Z0Z00000000000000000000000000000000000000000
000000000000000000ZZ0000000000000000000000000Z000000000000000000000000000000000000000000000Z00Z0Z000Z000Z00000000000000000000000000000000000000000
0000000000000000ZZZZ0000000000000000000000ZZZ0000000Z00000000000000ZZ00000000ZZZZZZ00000000Z00Z0Z000Z000Z0000000000000Z00Z00Z00Z000000000000000000
0000ZZZZ00000000ZZZZZZ00000000Z00Z00Z00Z00ZZZZ000000Z0000000000000ZZZ000000000000000000000000ZZ0ZZZZZZZZZ0000300000ZZ000000000000Z0000000000050000
000ZZZZZ00M0L00ZZZZZZZZ000M00ZZBBBBBBBBBBBZZZZ00N000Z000000M000000ZZZ00000000M00000N0000L000ZZZ000000000000000000M0ZZBBBBBBBBBBBBZ0000000000000000
E00000E000000E00E00000E0000000E000000E0000000E00000E0000E00000E00000E00000E00Q00E000000E00000000E000000E0000000000E000000E000000E0000000E0000E0000