188
15
Y000000000000000000000000000000000000000000000000000000000000000G0000000G0000000000000000000000000000000000000000000000000000000000000000000000000000000000000000000000000000000000000000000
0000000000000000000000000000000000000000000000000000000000000000G0000000G0000000000000000000000000000000000000000000000000000000000000000000000000000000000000000000000000000000000000000000
0000000000000000000000000000000000000000000000000000000000000000G00GGGG0G0000000000000000000000000000000000000000000000000000000000000000000000000000000000000000000000000000000000000000000
0000000000000000000000000000000000000000000000000000000000000000G00G0000G00000000000000000000000000000000000000000000000000000000000000000000000000000000000000000000G0000000000000000000000
0000000000000000000000000000000000000000000000000000000000000000GG0G0000G00000000000000000000000000000000000000000000000000000000000000000000000000000000000000000000000GGGG0000000000000000
0000000000000000000000000000000000000000000000000000000000000000G00G0000G000000000000000000000000000000000000000000000000000000000000000000000000000000000000000000G0000G000000GGGG000000000
0000000000000000000000000000000000000000000000000000000000000000G00G0000G00000000000000000000000000000000000000000000000000000000000000000000000000000000000000000000000G000000000GG00000000
00000000000000000000000GGGGG000GGGG00000000000000000000000000000G0GG00GGG0000000GGGGGGG000GG00G00G00GGGGGGG00000000000000000000GGGG0000000GGGG00000000000000000GG0000000GGGG000000GGG0000000
000000000000000000000000000GGGGG0000000000000000GGGG000000000000G00G000000000000000G000000G0G0000G00000G00000000000000000000000000G0000000G00000000000000000GG0000000000G000000000GGGG000000
00000000000000000000GG000000000000000000000000000000000000000000G00G000000000000000G000000G00G000G00000G00000G00000000000000000000G0000000G000000000000000000000000000GGG000GGGGGGGGGGG00000
000000000000000000000000000000000000GG00000000000000000000000000GG0GG00000000000000G000000G000G00G00000G00000GGG000000000000000000GGGGGGGGG00000000000000GG0000000000000000GGGGGGGGGGGGG0000
00030GG0000000000GG0000GG000G000GG00GGG0000GGGGG0000000000000000G00G0000GG000000000G000000G0000G0G00000G00000GGGG00000000000GG00000000000000000GG0000000000000000000000000GGGGGGGGGGGGGGGGGG
S000FGGG00000S0000F0000000F0S000F000GGGG000000000000000GG0000000000G0000GG000000000G000000G0G000GG00000G00000GGGG000GG000000GG00000G0G0G0G00000GG00000GG00000000000000GGGGGGGGGGGGGGGGGGGGGG
00000GGGG00000GVVV000000000000000000GGGG000000000000000GG0000000000G0000GG000000000G000000G000000G00000G00000GGGG000GG000000GG000G000000000G000GG0000000000G00000000GGGGGGGGGGGGGGGGGGGGGGGG
A000A000A00A0A000A00A00A0A00A00A000A00A000A00A00A000A0A00A00A0A000A00A00A00A0A00A00A0A0A00A000A00A00A000A0000A00A000A00A00A0000A000A0000A000AA000A0AA00A00AA000A000A000A000A00A000A00A00AA00